11111111111111111111111111111111
1..............P...............1
1..............................1
1..............................1
1..............................1
1..............................1
1..............................1
1................111111111111111
1111111111111111...............1
1...........................S..1
1..S...........................1
1..............................1
1...........................M..1
1..M...........................1
1................111111111111111
1111111111111111...............1
1..............................1
1..............................1
1..............................1
1..............................1
1..............................1
1..............................1
1...............B..............1
11111111111111111111111111111111
