11111111111111111111111111111111
1..............P...............1
111.....11..........11......11.1
1....1....1.1..1.1......1..1..11
1..............................1
1..............................1
1.11...11..11.......11..11.....1
11..1.1......1..1..1......1....1
1..............................1
1...1..........................1
1..1...11...11..11...11........1
1.1........1......1......111...1
11.............................1
1..............................1
1..............................1
1..............................1
1..............................1
1..............................1
1..............................1
1..............................1
1..............................1
1..............................1
1.............B................1
11111111111111111111111111111111